border_size=1
usage=map

Xv          , Xv          , Xv          , Xv          , Xv          , Xv          , Xv          , Xv          , Xv          , Xv          , Xv          , Xv          , Xv          , Xv          , Xv          , Xv          , Xv          , Xv          , Xv          , Xv          , Xv          , Xv          , Xv          , Xv          , Xv          , Xv          , Xv          , Xv          , Xv          , Xv          , Xv          , Xv          , Xv          , Xv          , Xv          
Xv          , Xv          , Xv          , Xv          , Xv          , Xv          , Xv          , Xv          , Xv          , Xv          , Xv          , Xv          , Dd          , Xv          , Xv          , Xv          , Gs^Fdw      , Ss          , Gs^Fdf      , Xv          , Xv          , Xv          , Gs^Fp       , Xv          , Xv          , Xv          , Xv          , Xv          , Xv          , Xv          , Xv          , Xv          , Xv          , Xv          , Xv          
Xv          , Xv          , Xv          , Xv          , Xv          , Xv          , Xv          , Xv          , Xv          , Xv          , Dd          , Dd          , Re          , Re          , Re          , Gs^Fdf      , Ss          , Ss          , Ss          , Wot         , Ww          , Re          , Re          , Gs^Fdf      , Gs^Fp       , Xv          , Xv          , Xv          , Xv          , Xv          , Xv          , Xv          , Xv          , Xv          , Xv          
Xv          , Xv          , Xv          , Xv          , Xv          , Xv          , Xv          , Xv          , Dd^Dc       , Dd          , Re          , Dd          , Re          , Re          , Re          , Re          , Re          , Gs^Fdf      , Wwf         , Wwf         , Wwf         , Re          , Re          , Rr          , Gs^Fdf      , Gs^Fmf      , Gs^Fmf      , Xv          , Xv          , Xv          , Xv          , Xv          , Xv          , Xv          , Xv          
Xv          , Xv          , Xv          , Xv          , Xv          , Xv          , Xv          , Xv          , Dd          , Re          , Hhd^Fmf     , Gd^Fdf      , Re          , Gs^Fmf      , Re          , Re          , Wwf         , Wwf         , Re          , Re          , Re          , Wwf         , Wwf         , Rr          , Re          , Gs^Fp       , Gs^Fdf      , Xv          , Xv          , Xv          , Xv          , Xv          , Xv          , Xv          , Xv          
Xv          , Xv          , Xv          , Xv          , Xv          , Xv          , Xv          , Xv          , Hhd^Eff     , Re          , Re          , Re          , Rr          , Rr^Vd       , Rr          , Re          , Wwf         , Chw         , Re          , Gd^Fdf      , Re          , Re          , Chw         , Wwf         , Wwf         , Re          , Hhd         , Xv          , Xv          , Xv          , Xv          , Xv          , Xv          , Xv          , Xv          
Xv          , Xv          , Xv          , Xv          , Xv          , Xv          , Re^Gvs      , Re^Gvs      , Rp^Vhcr     , Rr^Eff      , Rr          , Rr          , Re          , Ss          , Wwf         , Wwf         , Chr         , Chr         , Chr         , Re          , Rr          , Rr          , Re          , Rr^Vd       , Wwf         , Re          , Re          , Md          , Gs^Fdw      , Xv          , Xv          , Xv          , Xv          , Xv          , Xv          
Xv          , Xv          , Xv          , Xv          , Xv          , Re^Gvs      , Hhd^Eff     , Gs^Fp       , Ss^Eff      , Re^Eff      , Re          , Re          , Wwf         , Wwf         , Re          , 2 Khw       , Re          , Khw         , Wwf         , Chr         , Rr          , Gll^Fmf     , Re          , Re          , Wwf         , Hhd         , Gll^Fmf     , Re          , Re          , Gs^Fdf      , Xv          , Xv          , Xv          , Xv          , Xv          
Xv          , Xv          , Xv          , Xv          , Xv          , Gs^Fdf      , Re          , Ss^Eff      , Re          , Re          , Re          , Re          , Wwf         , Re          , Re          , Re          , Ww          , Chw         , Wwf         , Rr          , Rr          , Re          , Re          , Re          , Re          , Wwf         , Wwf         , Re          , Re          , Gs^Fdw      , Xv          , Xv          , Xv          , Xv          , Xv          
Xv          , Xv          , Xv          , Xv          , Xv          , Gs^Fdf      , Ss          , Re          , Re          , Re          , Re          , Re          , Wwf^Bw/r    , Hhd         , Ww          , Ww^Bw|      , Wwf         , Khw         , Rr          , Rr          , Gd^Fdf      , Rr          , Rr          , Rr          , Rr          , Rr          , Wwf         , Re          , Re          , Hh^Uf       , Xv          , Xv          , Xv          , Xv          , Xv          
Xv          , Xv          , Xv          , Xv          , Xv          , Gs^Fdf      , Ss          , Re          , Re          , Re          , Gll^Fmf     , Ss^Vhs      , Dd^Edp      , Wwf         , Re          , Rr          , Rr          , Rr          , Re          , Re          , Ss          , Ss^Vhs      , Re          , Hhd         , Re^Uf       , Re          , Wwf         , Rr          , Re          , Gs^Fdf      , Xv          , Xv          , Xv          , Xv          , Xv          
Xv          , Xv          , Xv          , Xv          , Gs^Fdf      , Uu^Uf       , Re          , Ke          , Re^Dr       , Re          , Uu^Uf       , Gd^Fdf      , Dd          , Wwf         , Rr^Vd       , Rr          , Rr          , Re          , Wwf         , Wwf         , Re          , Wwf^Bw|r    , Wwf^Bw\r    , Re          , Ss          , Wwf         , Re          , Rr^Vd       , Re          , Hhd         , Uu^Uf       , Xv          , Xv          , Xv          , Xv          
Xv          , Xv          , Gs^Fdf      , Hh^Fdf      , Ss          , Ur          , Re          , Ce          , Ce          , Gs^Fdf      , Uu          , Hd          , Re          , Wwf         , Wwf         , Rr          , Wwf         , Wwf         , Re          , Re          , Re          , Re^Bw|r     , Re          , Chs         , Re          , Md          , Re          , Wwf         , Re          , Md          , Gs^Fp       , Ur          , Ss          , Xv          , Xv          
Xv          , Xv          , Gs^Fdf      , Ss          , Re          , Re          , Re          , Re          , Re          , Re          , Re          , Re          , Re          , Re          , Wwf         , Wwf         , Re          , Ch          , Re          , Re          , Rr          , Chr         , Re          , Ss          , Hhd         , Re          , Re          , Wwf         , Wwf         , Re          , Re          , Re          , Ss          , Xv          , Xv          
Xv          , Xv          , Hh^Fdf      , Ur          , Re          , Re^Vct      , Ss          , Hhd         , Re          , Re          , Re          , Re          , Ww          , Wwf         , Gd^Fdf      , Gll^Fmf     , Re          , Re          , Re          , Re          , Wwf         , Rr^Vd       , Hhd         , Wwf         , Chw         , Gd^Fdf      , Gll^Fmf     , Re          , Wwf         , Re          , Ss          , Re          , Gs^Fdf      , Xv          , Xv          
Xv          , Xv          , Wot         , Gs^Fdf      , Re          , Uu^Uf       , Xu          , Re          , Re          , Re          , Gs^Fdw      , Wot         , Chw         , Wwf         , Xu          , Uu^Uf       , Ur          , Hhd         , Re          , Wwf         , Re^Uf       , Gs^Fdf      , Re          , Wwf         , Ww          , Wwf         , Wwf         , Wwf         , Re          , Uu^Uf       , Re          , Re          , Gs^Fdf      , Xv          , Xv          
Xv          , Xv          , Gs^Fdf      , Md          , Re          , Re          , Re          , Re          , Ss          , Ww          , Re          , Ss          , Gll^Fmf     , Wwf         , Uu          , Ss          , Uu^Uf       , Gs^Fdf      , Hhd         , Wwf         , Wwf         , Re          , Re          , Re          , Chw         , Ww          , Gs^Fdw      , Rr          , Re          , Re          , Re          , Hhd         , Chs         , Xv          , Xv          
Xv          , Xv          , Chs         , Hh^Fmf      , Re          , Re          , Re          , Uu^Uf       , Gs^Fdw      , Ww          , Chw         , Re          , Re          , Wwf         , Wwf         , Re          , Hhd         , Re          , Uu^Uf       , Re          , Uu          , Wwf         , Gll^Fmf     , Re          , Re          , Ww          , Ss          , Uu^Uf       , Re          , Re          , Re          , Hh^Fmf      , Gs^Fdf      , Xv          , Xv          
Xv          , Xv          , Gs^Fdf      , Hhd         , Re          , Re          , Re          , Rr          , Wwf         , Ww          , Ww          , Re          , Re          , Re          , Re^Uf       , Wwf         , Re          , Gs^Fdf      , Ur          , Ss          , Xu          , Wwf         , Chw         , Re          , Gs^Fdw      , Ww          , Re          , Re          , Xu          , Re          , Re          , Md          , Wot         , Xv          , Xv          
Xv          , Xv          , Gs^Fdf      , Re          , Ss          , Uu^Uf       , Wwf         , Wwf         , Gll^Fmf     , Wwf         , Chw         , Wwf         , Hhd         , Gs^Fdf      , Wwf         , Wwf         , Re          , Hhd         , Re          , Uu^Uf       , Gd^Fdf      , Wwf         , Ww          , Wot         , Re          , Re          , Re          , Re          , Ss          , Uu^Uf       , Re          , Gs^Fdf      , Hh^Fdf      , Xv          , Xv          
Xv          , Xv          , Ss          , Re          , Re          , Re          , Wwf         , Re          , Re          , Gd^Fdf      , Hhd         , Wwf         , Re          , Rr^Vd       , Rr          , Re          , Re          , Re          , Re          , Gll^Fmf     , Wwf         , Wwf         , Re          , Re          , Re          , Re          , Re          , Hhd         , Re          , Re^Vct      , Re          , Ur          , Gs^Fdf      , Xv          , Xv          
Xv          , Xv          , Ss          , Re          , Gs^Fp       , Re          , Re          , Wwf         , Re          , Re          , Re          , Ss          , Re          , Chr         , Re          , Re          , Re          , Ch          , Wwf         , Wwf         , Wwf         , Re          , Re          , Re          , Ur          , Re          , Ce          , Re          , Re          , Re          , Ss          , Ss          , Gs^Fdf      , Xv          , Xv          
Xv          , Xv          , Xv          , Ur          , Uu^Uf       , Md          , Re          , Wwf         , Re          , Md          , Ss          , Chs         , Wwf^Bw\r    , Re^Bw|r     , Re          , Re          , Wwf         , Wwf         , Rr          , Rr          , Rr^Vd       , Wwf         , Dd          , Hd          , Uu^Uf       , Gd^Fdf      , Re^Dr       , Ce          , Re          , Ur          , Gs^Fdf      , Hh^Fdf      , Xv          , Xv          , Xv          
Xv          , Xv          , Xv          , Xv          , Xv          , Hhd         , Re          , Rr^Vd       , Wwf         , Wwf         , Re^Uf       , Re          , Re          , Wwf^Bw|r    , Ss          , Wwf         , Re          , Re          , Rr          , Rr          , Re          , Wwf         , Dd^Edp      , Gd^Fdf      , Gll^Fmf     , Re          , Re          , Ke          , Ss          , Uu^Uf       , Xv          , Xv          , Xv          , Xv          , Xv          
Xv          , Xv          , Xv          , Xv          , Xv          , Gs^Fdf      , Re          , Rr          , Wwf         , Re          , Rr          , Hhd         , Rr          , Ss^Vhs      , Gd^Fdf      , Re          , Rr          , Rr          , Wwf         , Re          , Ww          , Wwf         , Wwf^Bw/r    , Ss^Vhs      , Re          , Re          , Re          , Re          , Ss          , Gs^Fdf      , Xv          , Xv          , Xv          , Xv          , Xv          
Xv          , Xv          , Xv          , Xv          , Xv          , Hh^Uf       , Re          , Re          , Wwf         , Rr          , Re          , Rr          , Re          , Rr          , Rr          , Rr          , Wwf         , Khw         , Ww          , Ww^Bw|      , Re          , Hhd         , Wwf         , Re          , Re          , Re          , Re          , Re          , Re          , Gs^Fdf      , Xv          , Xv          , Xv          , Xv          , Xv          
Xv          , Xv          , Xv          , Xv          , Xv          , Gs^Fdw      , Re          , Re          , Gll^Fmf     , Wwf         , Wwf         , Re          , Re          , Re          , Rr          , Rr          , Wwf         , Chw         , Re          , Re          , Re          , Re          , Wwf         , Re          , Re          , Re          , Ss^Eff      , Ss^Eff      , Hhd^Eff     , Gs^Fdf      , Xv          , Xv          , Xv          , Xv          , Xv          
Xv          , Xv          , Xv          , Xv          , Xv          , Gs^Fdf      , Gs^Fdw      , Re          , Re          , Hhd         , Wwf         , Re          , Re          , Gll^Fmf     , Rr          , Chr         , Chr         , Khr         , Chr         , 1 Khw       , Wwf         , Wwf         , Re          , Re          , Rr          , Re^Eff      , Rp^Vhcr     , Gs^Fp       , Re^Gvs      , Re^Gvs      , Xv          , Xv          , Xv          , Xv          , Xv          
Xv          , Xv          , Xv          , Xv          , Xv          , Xv          , Xv          , Md          , Hhd         , Re          , Wwf         , Rr^Vd       , Chw         , Rr          , Re          , Re          , Re          , Chr         , Wwf         , Wwf         , Rr          , Ss          , Rr          , Rr          , Re          , Rr^Eff      , Hhd^Eff     , Re^Gvs      , Xv          , Xv          , Xv          , Xv          , Xv          , Xv          , Xv          
Xv          , Xv          , Xv          , Xv          , Xv          , Xv          , Xv          , Xv          , Gs^Fdf      , Re          , Re          , Wwf         , Wwf         , Re          , Re          , Gd^Fdf      , Re          , Chw         , Wwf         , Re          , Re          , Rr^Vd       , Re          , Re          , Hhd^Fmf     , Re          , Dd          , Xv          , Xv          , Xv          , Xv          , Xv          , Xv          , Xv          , Xv          
Xv          , Xv          , Xv          , Xv          , Xv          , Xv          , Xv          , Xv          , Gs^Fmf      , Gs^Fp       , Gs^Fdf      , Rr          , Re          , Wwf         , Wwf         , Re          , Wwf         , Wwf         , Re          , Re          , Re          , Gs^Fmf      , Re          , Gd^Fdf      , Re          , Re          , Dd^Dc       , Xv          , Xv          , Xv          , Xv          , Xv          , Xv          , Xv          , Xv          
Xv          , Xv          , Xv          , Xv          , Xv          , Xv          , Xv          , Xv          , Xv          , Gs^Fmf      , Gs^Fp       , Rr          , Re          , Re          , Ww          , Wwf         , Ss          , Gs^Fdf      , Ss          , Re          , Re          , Re          , Re          , Dd          , Dd          , Dd          , Xv          , Xv          , Xv          , Xv          , Xv          , Xv          , Xv          , Xv          , Xv          
Xv          , Xv          , Xv          , Xv          , Xv          , Xv          , Xv          , Xv          , Xv          , Xv          , Xv          , Gs^Fdf      , Gs^Fp       , Re          , Xv          , Wot         , Gs^Fdf      , Ss          , Gs^Fdw      , Gs^Fdf      , Xv          , Re          , Dd          , Dd          , Xv          , Xv          , Xv          , Xv          , Xv          , Xv          , Xv          , Xv          , Xv          , Xv          , Xv          
Xv          , Xv          , Xv          , Xv          , Xv          , Xv          , Xv          , Xv          , Xv          , Xv          , Xv          , Xv          , Xv          , Xv          , Xv          , Xv          , Xv          , Ss          , Xv          , Xv          , Xv          , Xv          , Xv          , Xv          , Xv          , Xv          , Xv          , Xv          , Xv          , Xv          , Xv          , Xv          , Xv          , Xv          , Xv          
Xv          , Xv          , Xv          , Xv          , Xv          , Xv          , Xv          , Xv          , Xv          , Xv          , Xv          , Xv          , Xv          , Xv          , Xv          , Xv          , Xv          , Xv          , Xv          , Xv          , Xv          , Xv          , Xv          , Xv          , Xv          , Xv          , Xv          , Xv          , Xv          , Xv          , Xv          , Xv          , Xv          , Xv          , Xv          
