border_size=1
usage=map

Urb         , Xos         , Xos         , Urb         , Urb         , Xos         , Hhd^Uf      , Rrc         , Wwf         , Wwf         , Rrc         , Rrc         , Xos         , Md          , Hhd         , Rrc         , Wwf         , Rrc         , Rrc         , Gd          , Gd          , Hhd^Fmf     , Hhd         , Xos         , Xos         , Urb         , Urb         , Xos         , Xos         , Xos         , Xos         , Xos         , Xos         , Xos         , Xos         , Xos         , Xos         , Hhd         , Md          
Xos         , Urb         , Urb         , Xos         , Gd          , Gd^Fmw      , Rrc^Vo      , Rrc         , Wwf         , Rrc         , Urb         , Urb         , Urb         , Hhd^Uf      , Gd^Fetd     , Rrc         , Rrc         , Wwf         , Wwf         , Rrc         , Gd          , Gd          , Gd          , Hhd^Uf      , Gd          , Rrc         , Rrc         , Urb         , Coa         , Coa         , Xos         , Urb         , Xos         , Urb         , Xos         , Hhd         , Hhd^Fetd    , Hhd         , Hhd         
Xos         , Xos         , Gd          , Gd          , Rrc         , Rrc         , Wwf         , Wwf         , Xos         , Xos         , Urb         , Xos         , Xos         , Coa         , Gd          , Gd          , Rrc         , Rrc         , Wwf         , Rrc         , Rrc         , Hhd         , Hhd^Fmw     , Gd^Vo       , Gd          , Gd          , Gd          , Rrc         , Gd^Fmw      , Coa         , Gd          , Gd          , Gd          , Gd          , Hhd         , Md          , Gd^Fmw      , Gd^Fmf      , Rrc         
Hhd         , Xos         , Gd^Uf       , Gd          , Rrc         , Wwf         , Ai          , Ai          , Urb         , Urb         , Urb         , Urb         , Coa         , Coa         , Rrc         , Rrc         , Wwf         , Wwf         , Rrc         , Wwf         , Wwf         , Rrc         , Hhd         , Gd          , Gd          , Gd          , Ko          , Gd          , Gd          , Gd          , Gd          , Gd          , Gd          , Gd          , Gd^Fmf      , Hhd         , Rrc         , Rrc         , Wwf         
Hhd         , Gd^Fmf      , Rrc         , Rrc         , Wwf         , Wwf         , Rrc         , Coa         , Urb         , Urb         , Urb         , Urb         , Gd          , Gd^Vo       , Rrc         , Wwf         , Rrc         , Rrc         , Hhd^Fetd    , Rrc         , Wwf         , Rrc         , Rrc         , Gd          , Co          , Co          , Gd          , Gd          , Gd          , Gd^Uf       , Md          , Hhd^Fmw     , Hhd^Vo      , Gd          , Hhd         , Md          , Rrc         , Wwf         , Wog         
Md          , Hhd         , Rrc         , Wwf         , Rrc         , Rrc         , Gd^Fmw      , Xos         , Xos         , Urb         , Gd^Uf       , Gd^Fmw      , Gd          , Rrc         , Wwf         , Wwf         , Rrc         , Hhd         , Gd^Uf       , Rrc         , Rrc         , Wwf         , Wwf         , Rrc         , Gd^Fetd     , Hhd^Uf      , Hhd^Vo      , Gd^Fetd     , Gd          , Hhd         , Gd^Fetd     , Hhd         , Gd^Fmw      , Gd          , Gd          , Rrc         , Wwf         , Wwf         , Wog         
Hhd         , Rrc         , Wwf         , Wwf         , Wwf         , Ss^Vhs      , Rrc         , Gd          , Gd          , Hhd         , Hhd         , Gd          , Co          , Co          , Wwf         , Rrc         , Gd^Uf       , Gd          , Gd          , Gd          , Hhd^Fmw     , Rrc         , Wwf         , Rrc         , Gd          , Hhd^Fmf     , Rrc         , Rrc         , Rrc         , Gd          , Rrc         , Gd          , Gd          , Gd          , Rrc         , Rrc         , Wwf         , Wog         , Wwf         
Gd^Fmf      , Rrc         , Wwf         , Rrc         , Rrc         , Wwf         , Wwf         , Rrc         , Rrc         , Gd^Fmf      , Rrc         , Ko          , Rrc         , Rrc         , Wwf         , Rrc         , Mm          , Gd^Fetd     , Gd          , Gd^Fdw      , Rrc         , Rrc         , Ai          , Rrc         , Rrc         , Rrc         , Wwf         , Wwf         , Wwf         , Rrc         , Wwf         , Rrc         , Rrc         , Rrc         , Wwf         , Wwf         , Rrc         , Wwf         , Rrc         
Rrc         , Rrc         , Wwf         , Rrc         , Wwf         , Wwf         , Wog         , Wwf         , Wwf         , Rrc         , Wwf         , Rrc         , Wwf         , Wwf         , Wwf         , Rrc         , Rrc         , Hhd^Fmw     , Rrc         , Rrc         , Xos         , Rrc         , Xos         , Ai          , Ai          , Wwf         , Rrc         , Rrc         , Rrc         , Wwf         , Rrc         , Wwf         , Wwf         , Wwf         , Co          , Co          , Co          , Rrc         , Gd          
Wwf         , Wwf         , Wog         , Wwf         , Wog         , Wog         , Wog         , Wog         , Wwf         , Wwf         , Rrc^Vo      , Wwf         , Rrc         , Rrc         , Rrc         , Wwf         , Wwf         , Rrc         , Xos         , Xos         , Xos         , Urb         , Urb         , Xos         , Rrc         , Rrc         , Hhd         , Md          , Gd          , Rrc         , Gd          , Rrc         , Rrc         , Rrc         , Gd          , Ko          , Gd          , Gd          , Gd^Fmf      
Wog         , Wog         , Wwf         , Wwf         , Wwf         , Wog         , Wwf         , Wwf         , Rrc         , Rrc         , Gd          , Rrc         , Hhd         , Gd^Fetd     , Rrc         , Wwf^Bsb\    , Ai^Bsb\     , Ai          , Ai          , Ai^Bsb|     , Ai          , Urb         , Urb         , Urb         , Rrc         , Gd          , Ko          , Gd^Uf       , Gd          , Gd          , Gd^Vo       , Gd          , Hhd^Fetd    , Gd^Fmf      , Gd          , Gd          , 1 Co        , Gd          , Gd          
Wwf         , Wwf         , Co          , Co          , Co          , Wwf         , Rrc         , Rrc         , Gd          , Gd          , Hhd^Uf      , Gd          , Gd          , Gd          , Rrc         , Wwf         , Ai          , Ai^Bsb\     , Coa         , Coa         , Coa         , Ai^Bsb/     , Uh          , Xos         , Xos         , Co          , Gd          , Gd          , Hhd         , Hhd^Fetd    , Hhd^Fmw     , Gd          , Gd          , Hhd^Uf      , Rrc         , Rrc         , Rrc         , Rrc         , Rrc         
Rrc         , Rrc         , Rrc         , Ko          , Rrc         , Rrc         , Gd          , Gd          , Hhd^Fmw     , Mm          , Hhd         , Gd^Fmf      , Gd          , Rrc         , Xos         , Xos         , Uh          , Ai          , Coa         , Coa         , Coa         , Ai          , Ai          , Xos         , Rrc         , Rrc         , Gd          , Gd^Fmf      , Hhd^Uf      , Mm          , Gd          , Gd          , Rrc         , Rrc         , Co          , Ko          , Co          , Wwf         , Wwf         
Gd          , Gd          , 2 Co        , Rrc         , Gd          , Hhd^Uf      , Hhd^Fetd    , Gd          , Gd^Vo       , Hhd^Fetd    , Gd          , Gd          , Ko          , Co          , Rrc         , Xos         , Urb         , Ai^Bsb/     , Ai          , Coa         , Ai          , Ai^Bsb\     , Ai^Bsb\     , Wwf         , Rrc         , Gd          , Hhd         , Gd          , Gd          , Gd          , Rrc         , Rrc         , Wwf         , Wwf         , Wwf         , Co          , Wwf         , Wwf         , Wog         
Gd^Fmf      , Gd          , Gd          , Gd          , Gd          , Gd^Fmf      , Rrc         , Gd          , Gd          , Gd          , Gd          , Gd^Uf       , Hhd         , Gd          , Rrc         , Urb         , Urb         , Urb         , Xos         , Ai^Bsb|     , Xos         , Ai          , Wwf         , Wwf^Bsb\    , Rrc         , Gd^Fetd     , Rrc         , Rrc         , Rrc^Vo      , Rrc         , Wwf         , Wwf         , Wog         , Wog         , Wog         , Wwf         , Wog         , Wog         , Wwf         
Gd          , Gd          , Co          , Ko          , Co          , Rrc         , Wwf         , Rrc         , Rrc         , Rrc         , Rrc         , Md          , Rrc         , Rrc         , Ai          , Xos         , Xos         , Urb         , Xos         , Xos         , Rrc         , Rrc         , Rrc         , Wwf         , Wwf         , Rrc         , Wwf         , Wwf         , Wwf         , Wwf         , Wwf         , Wog         , Wog         , Wog         , Wwf         , Wwf         , Wwf         , Wwf         , Rrc         
Rrc         , Rrc         , Rrc         , Co          , Wwf         , Wwf         , Rrc         , Wwf         , Wwf         , Wwf         , Wwf         , Rrc         , Wwf         , Wwf         , Rrc         , Ai          , Ai          , Rrc         , Rrc         , Rrc         , Gd          , Hhd^Fmw     , Mm          , Rrc         , Wwf         , Wwf         , Rrc         , Rrc         , Rrc         , Rrc         , Rrc         , Wwf         , Wwf         , Wwf         , Rrc         , Rrc         , Wwf         , Rrc         , Gd^Fmf      
Wwf         , Wwf         , Wwf         , Wwf         , Rrc         , Rrc         , Gd          , Rrc         , Rrc         , Rrc         , Rrc         , Wwf         , Rrc         , Rrc         , Gd          , Rrc         , Wwf         , Rrc         , Hhd^Fmw     , Gd^Fdw      , Gd          , Gd^Fetd     , Gd^Uf       , Rrc         , Wwf         , Rrc         , Co          , Ko          , Hhd         , Gd^Fmf      , Gd          , Rrc         , Rrc         , Wwf         , Wwf         , Rrc         , Wwf         , Rrc         , Hhd         
Wog         , Wog         , Wwf         , Rrc         , Gd          , Gd          , Gd^Fmf      , Gd          , Gd^Fetd     , Gd          , Gd          , Rrc         , Hhd^Vo      , Hhd^Fmf     , Gd^Fetd     , Rrc         , Wwf         , Rrc         , Rrc         , Gd          , Gd^Uf       , Gd          , Rrc         , Rrc         , Wwf         , Co          , Gd          , Gd          , Gd^Uf       , Hhd         , Xos         , Gd          , Gd^Fmw      , Ss^Vhs      , Rrc         , Wwf         , Rrc         , Rrc         , Md          
Wog         , Wwf         , Rrc         , Rrc         , Hhd         , Gd          , Hhd^Vo      , Hhd         , Md          , Hhd         , Gd          , Gd^Fetd     , Gd          , Hhd^Uf      , Co          , Rrc         , Rrc         , Wwf         , Wwf         , Rrc         , Hhd^Fetd    , Hhd         , Rrc         , Wwf         , Rrc         , Rrc         , Gd          , Gd^Fmw      , Urb         , Urb         , Urb         , Xos         , Rrc         , Rrc         , Wwf         , Wwf         , Rrc         , Hhd         , Hhd         
Wwf         , Wwf         , Rrc         , Md          , Gd^Fmf      , Gd          , Gd          , Hhd^Fmw     , Gd          , Gd^Uf       , Gd          , Gd          , Ko          , Co          , Gd          , Gd          , Hhd         , Rrc         , Wwf         , Rrc         , Rrc         , Rrc         , Wwf         , Wwf         , Rrc         , Gd^Vo       , Coa         , Urb         , Urb         , Urb         , Urb         , Coa         , Ai          , Wwf         , Rrc         , Rrc         , Gd^Uf       , Gd^Fmf      , Xos         
Rrc         , Rrc         , Gd^Fmw      , Hhd         , Hhd         , Gd          , Gd          , Gd          , Gd          , Gd          , Gd^Fmw      , Gd          , Gd          , Gd          , Gd          , Gd          , Hhd^Fmw     , Rrc         , Rrc         , Wwf         , Wwf         , Wwf         , Rrc         , Rrc         , Gd          , Coa         , Xos         , Urb         , Urb         , Urb         , Xos         , Ai          , Wwf         , Wwf         , Rrc         , Gd          , Gd          , Xos         , Xos         
Md          , Gd^Fmf      , Hhd^Fetd    , Md          , Xos         , Gd          , Xos         , Gd          , Xos         , Coa         , Coa         , Rrc         , Rrc         , Gd          , Gd          , Gd^Vo       , Gd          , Hhd         , Gd          , Rrc         , Wwf         , Rrc         , Rrc         , Gd          , Gd^Fetd     , Coa         , Urb         , Xos         , Urb         , Xos         , Wwf         , Wwf         , Rrc^Vo      , Rrc         , Gd          , Gd          , Xos         , Urb         , Urb         
Hhd         , Hhd         , Hhd         , Hhd         , Xos         , Urb         , Xos         , Urb         , Xos         , Coa         , Xos         , Urb         , Urb         , Rrc         , Xos         , Hhd^Uf      , Gd          , Gd          , Gd          , Rrc         , Rrc         , Wwf         , Wwf         , Rrc         , Hhd         , Hhd^Uf      , Xos         , Urb         , Rrc         , Rrc         , Wwf         , Rrc         , Gd          , Gd^Fmf      , Gd          , Gd          , Urb         , Xos         , Xos         
Hhd         , Md          , Hhd         , Xos         , Xos         , Xos         , Xos         , Xos         , Xos         , Xos         , Xos         , Xos         , Xos         , Urb         , Urb         , Xos         , Hhd         , Hhd^Fmf     , Gd^Fetd     , Gd          , Gd          , Rrc         , Wwf         , Rrc         , Gd          , Md          , Rrc         , Rrc         , Wwf         , Wwf         , Rrc         , Rrc         , Md          , Hhd         , Urb         , Xos         , Xos         , Urb         , Urb         
