border_size=1
usage=map

Xv          , Xv          , Xv          , Xv          , Xv          , Xv          , Xv          , Xv          , Xv          , Xv          , Xv          , Xv          , Xv          , Xv          , Xv          , Xv          , Xv          , Xv          , Xv          , Xv          , Xv          , Xv          , Xv          , Xv          , Xv          , Xv          , Xv          , Xv          , Xv          , Xv          , Xv          , Xv          , Xv          
Xv          , Ms^Xm       , Ms^Xm       , Ms^Xm       , Hhd^Fdw     , Hhd^Fmw     , Rd          , Re          , Re^Efm      , Rb          , Hhd         , Re^Fmw      , Rr          , Rr          , Koa^Xo      , Rr          , Re          , Re          , Rd          , Rd^Esd      , Rd          , Rd          , Rr          , Rd          , Rr          , Rd          , Rd          , Re          , Rb^Efm      , Rb          , Wwg         , Wwg         , Xv          
Xv          , Md          , Rb^Fdw      , Hhd         , Re          , Re^Fmw      , Hhd         , Rd          , Rd          , Re          , Rd          , Rd^Fdw      , Rr          , Koa^Xo      , Rr          , Rr          , Rd          , Rd          , Rd^Efm      , Rd^Voa      , Rd          , Rr          , Koa^Xo      , Rr          , Koa^Xo      , Rr          , Rr          , Re^Fdw      , Sm          , Re          , Wwg^Bw\     , Wwg         , Xv          
Xv          , Re^Fdw      , Hhd         , Rb^Fmw      , Rb          , Re^Voa      , Rr          , Rr          , Rr          , Rd          , Re^Uf       , Rd          , Rd          , Rr          , Rd          , Rd          , Wwf         , Wwf         , Wwf         , Wwf         , Wwf         , Rr          , Rr          , Koa^Xo      , Koa^Xo      , Koa^Xo      , Rr          , Hhd         , Wog         , Wwg         , Wwrg        , Re          , Xv          
Xv          , Sm          , Rb          , Rb^Efm      , Rb          , Re          , Rr          , Koa^Xo      , Rr          , Hhd         , Re^Fmw      , Re^Voa      , Rd^Efm      , Rd          , Wwf         , Wwf         , 2 Koa       , Coa         , Rd          , Rd^Efm      , Wwf         , Hhd^Fmw     , Re          , Rr          , Rr          , Rr          , Wwf         , Wwf         , Rd          , Wwg         , Re^Efm      , Wwf         , Xv          
Xv          , Re          , Rb          , Rb          , Re          , Re          , Rr          , Koa^Xo      , Rr          , Rd          , Rd          , Rd          , Rd          , Rd          , Wwf         , Coa         , Coa         , Coa         , Rr          , Rd          , Rr          , Wwf         , Wwf         , Sm          , Sm^Vhs      , Ai^Uf       , Rd          , Rd          , Md          , Wwf         , Sm          , Wwf         , Xv          
Xv          , Re          , Re          , Hhd         , Rd^Fmw      , Rd          , Sm          , Rr          , Wwf         , Rd          , Coa         , Coa         , Coa         , Rd          , Wwf         , Rd          , Rd          , Rr          , Koa^Xo      , Rr          , Koa^Xo      , Rr          , Re          , Hhd^Fmw     , Wwf         , Rd          , Rr          , Hhd         , Hhd^Fmw     , Rd^Fdw      , Rd          , Wwf         , Xv          
Xv          , Rr          , Rr          , Rr          , Rr          , Rd          , Wwf         , Wwf         , Rd          , Wwf         , Rr          , Koa         , Coa         , Wwf         , Hhd         , Rd          , Rd          , Rr          , Rr          , Koa^Xo      , Rr          , Rr          , Wwf         , Re          , Wwf         , Rr          , Koa^Xo      , Rr          , Rr          , Cha         , Rd^Fmw      , Wwf         , Xv          
Xv          , Koa^Xo      , Koa^Xo      , Koa^Xo      , Rr          , Wwf         , Rd^Voa      , Hhd^Fdw     , Rr          , Rr          , Koa^Xo      , Rr          , Wwf         , Re          , Re^Fdw      , Re          , Coa         , Rd^Esd      , Rd^Efm      , Rr          , Rd^Voa      , Wwf         , Rd          , Wwf         , Md          , Rr          , Koa^Xo      , Koa^Xo      , Rr          , Rd          , Wwf         , Wwf         , Xv          
Xv          , Rr          , Rr          , Rr          , Hhd^Fmw     , Wwf         , Rd          , Rd          , Rr          , Koa^Xo      , Rr          , Rr          , Rd          , Wwf         , Ai^Uf       , Coa         , Coa         , Rd          , Md          , Rd          , Rd          , Wwf         , Rd          , Rd^Fdw      , Hhd         , Rr          , Rr          , Koa^Xo      , Rr          , Wwf         , Rd^Efm      , Wwg         , Xv          
Xv          , Rd          , Re^Fdw      , Sm          , Wwf         , Wwf         , Wwf         , Wwf         , Wwf         , Rr          , Rd          , Rd^Efm      , Rd          , Wwf         , Rd          , Coa         , Wwf         , Wwf         , Rr          , Ai^Uf       , Rr          , Wwf         , Wwf         , Rd          , Wwf         , Rd          , Wwf         , Rr          , Wwf         , Wwf         , Wwf         , Wog         , Xv          
Xv          , Re          , Re^Fdw      , Hhd         , Wwf         , Re^Es       , Cha         , Re          , Ai^Uf       , Wwf         , Wwrg        , Sm^Vhs      , Cha         , Hhd^Fdw     , Rd^Fmw      , Wwf         , Rr          , Rr          , Koa^Xo      , Rr          , Koa^Xo      , Rr          , Rr          , Wwf         , Ai^Uf       , Wwf         , Cha         , Wwf         , Rd^Fmw      , Hhd         , Sm          , Wwrg        , Xv          
Xv          , Sm          , Rd          , Rd^Efm      , Wwg         , Wwf         , Hhd^Fmw     , Rr          , Rr          , Re          , Rr          , Wwf         , Wwf         , Wwf         , Wwf         , Wwf         , Rr          , Koa^Xo      , Rr          , Koa^Xo      , Rr          , Rr          , Koa^Xo      , Rr          , Re^Efm      , Cha         , Rd          , Cha         , Wwf         , Rd          , Wwrg        , Wwg         , Xv          
Xv          , Wog         , Rd^Esd      , Wog         , Wwf         , Wwf         , Md          , Hhd         , Re          , Rr          , Koa^Xo      , Rr          , Rr          , Hhd^Fmw     , Re          , Wwf         , Wwf         , Rr          , Re          , Rr          , Rr          , Koa^Xo      , Koa^Xo      , Rr          , Re          , Re^Fdw      , Md          , Rd          , Wwf         , Wwf         , Rd^Esd      , Wwg         , Xv          
Xv          , Wwg         , Wwrg        , Wwf         , Wwf         , Rd          , Rd          , Re^Fdw      , Re^Efm      , Rr          , Koa^Xo      , Koa^Xo      , Rr          , Rr          , Rr          , Rr          , Rr          , Wwf         , Wwf         , Hhd^Fmw     , Wwf         , Rr          , Rr          , Rr          , Rr          , Hhd         , Hhd^Fmw     , Wwf         , Wwg         , Wog         , Rd          , Wog         , Xv          
Xv          , Wwg         , Sm          , Rd          , Rd^Fmw      , Cha         , Cha         , Cha         , Ai^Uf       , Rr          , Rr          , Rr          , Koa^Xo      , Koa^Xo      , Koa^Xo      , Koa^Xo      , Rr          , Wwf         , Rd^Fmw      , Wwf         , Cha         , Wwf         , Wwrg        , Re          , Ai^Uf       , Rr          , Cha         , Wwf         , Wwf         , Rd^Efm      , Re^Fdw      , Sm          , Xv          
Xv          , Wwrg        , Wwf         , Hhd         , Wwf         , Wwf         , Wwf         , Wwf         , Wwf         , Wwf         , Wwf         , Rr          , Rr          , Rr          , Rr          , Rr          , Wwf         , Wwf         , Rd          , Hhd^Fdw     , Rd          , Sm^Vhs      , Rd          , Wwf         , Wwf         , Re          , Wwf         , Re^Es       , Wwf         , Hhd         , Re^Fdw      , Re          , Xv          
Xv          , Wog         , Rd^Efm      , Wwf         , Rr          , Rr          , Rr          , Rd          , Hhd         , Rd          , Rd          , Wwf         , Rd          , Ai^Uf       , Md          , Wwf         , Coa         , Coa         , Ai^Uf       , Wwf         , Rd          , Rd^Efm      , Rr          , Rr          , Rr          , Wwf         , Rd          , Wwf         , Hhd^Fmw     , Sm          , Rr          , Rd          , Xv          
Xv          , Wwg         , Wwf         , Wwf         , Rr          , Koa^Xo      , Koa^Xo      , Rr          , Md          , Rd^Fdw      , Rd          , Wwf         , Rd^Voa      , Rd          , Rd^Efm      , Rd          , Coa         , Coa         , Re^Fdw      , Wwf         , Wwf         , Rr          , Koa^Xo      , Koa^Xo      , Rr          , Rd          , Rd^Voa      , Wwf         , Rr          , Rr          , Koa^Xo      , Rr          , Xv          
Xv          , Wwf         , Rd^Fmw      , Rd          , Rr          , Koa^Xo      , Koa^Xo      , Rr          , Wwf         , Wwf         , Wwf         , Wwf         , Rr          , Rr          , Rr          , Rd^Esd      , Rd          , Re          , Hhd         , Re          , Coa         , Rr          , Rr          , Rr          , Rd          , Hhd^Fdw     , Wwf         , Wwf         , Rr          , Koa^Xo      , Rr          , Koa^Xo      , Xv          
Xv          , Wwf         , Rd          , Cha         , Hhd^Fmw     , Rr          , Rr          , Rr          , Wwf         , Re          , Re          , Rr          , Koa^Xo      , Koa^Xo      , Koa^Xo      , Rr          , Rd          , Rd          , Wwf         , Wwf         , Coa         , Koa         , Coa         , Wwf         , Wwf         , Wwf         , Sm          , Rd          , Rd^Fmw      , Rr          , Re          , Rr          , Xv          
Xv          , Wwf         , Sm          , Rd^Fdw      , Md          , Hhd         , Rd          , Rd          , Sm^Vhs      , Hhd^Fmw     , Wwf         , Rr          , Rr          , Rr          , Rr          , Rr          , Coa         , Rd          , Wwf         , Rd          , Rd          , Coa         , Rd          , Rd          , Rr          , Rr          , Rr          , Rd          , Re          , Hhd         , Rb          , Re          , Xv          
Xv          , Wwf         , Re^Efm      , Wwf         , Rd          , Rd          , Wwf         , Ai^Uf       , Rr          , Sm          , Re          , Wwf         , Wwf         , Rd          , Rd          , Coa         , 1 Koa       , Coa         , Wwf         , Rd          , Rd^Efm      , Rd          , Re^Fmw      , Rd          , Rr          , Koa^Xo      , Rr          , Re          , Rb          , Rb          , Rb          , Re          , Xv          
Xv          , Wwf         , Wwrg        , Wwg         , Wog         , Wwf         , Rr          , Rr          , Koa^Xo      , Rr          , Rr          , Hhd^Fmw     , Wwf         , Rd^Efm      , Wwf         , Coa         , Wwf         , Wwf         , Rd          , Rd          , Rd          , Re^Voa      , Re^Uf       , Hhd         , Rr          , Koa^Xo      , Rr          , Re          , Rb          , Rb^Efm      , Hhd         , Sm          , Xv          
Xv          , Re          , Wwg^Bw\     , Wwg         , Sm          , Hhd         , Rr          , Koa^Xo      , Koa^Xo      , Koa^Xo      , Koa^Xo      , Rr          , Rd          , Wwf         , Rd^Efm      , Wwf         , Rd          , Rd          , Rr          , Rr          , Rr          , Rd          , Rd          , Rd          , Rd          , Rr          , Hhd         , Re^Voa      , Re          , Rb^Fmw      , Rb^Fdw      , Re^Fdw      , Xv          
Xv          , Wwg         , Wwg         , Re          , Rb^Efm      , Re^Fdw      , Rd          , Rr          , Rr          , Rr          , Rr          , Rr          , Rd          , Rd^Voa      , Rd          , Rd          , Re          , Rr          , Koa^Xo      , Koa^Xo      , Rr          , Rd^Fdw      , Hhd         , Re          , Re^Efm      , Rd          , Rd          , Re^Fmw      , Hhd^Fp      , Hhd         , Ms^Xm       , Md          , Xv          
Xv          , Wwg         , Xv          , Rb          , Xv          , Re          , Xv          , Rd          , Xv          , Rd          , Xv          , Rd          , Xv          , Rd^Esd      , Xv          , Re          , Xv          , Rr          , Xv          , Rr          , Xv          , Re^Fmw      , Xv          , Rb          , Xv          , Re          , Xv          , Hhd^Fmw     , Xv          , Ms^Xm       , Xv          , Ms^Xm       , Xv          
Xv          , Xv          , Xv          , Xv          , Xv          , Xv          , Xv          , Xv          , Xv          , Xv          , Xv          , Xv          , Xv          , Xv          , Xv          , Xv          , Xv          , Xv          , Xv          , Xv          , Xv          , Xv          , Xv          , Xv          , Xv          , Xv          , Xv          , Xv          , Xv          , Xv          , Xv          , Xv          , Xv          
