border_size=1
usage=map

Mm^Xm       , Gg          , Mm^Xm       , Gg          , Mm^Xm       , Gg          , Mm^Xm       , Gg          , Mm^Xm       , Gg          , Mm^Xm       , Gg          , Mm^Xm       , Hh^Fp       , Hh^Fp       , Hh^Fp       , Ss          , Ss          , Ss          , Ss          , Hh^Fp       , Gg          , Mm^Xm       , Gg          , Mm^Xm       , Gg          , Mm^Xm       , Gg          , Mm^Xm       , Mm^Xm       , Mm^Xm       , Mm^Xm       , Mm^Xm       , Mm^Xm       , Mm^Xm       , Mm^Xm       , Mm^Xm       
Mm^Xm       , Mm^Xm       , Mm^Xm       , Mm^Xm       , Mm^Xm       , Mm^Xm       , Hh^Fp       , Hh^Fp       , Gs^Fp       , Mm^Xm       , Hh^Fp       , Mm^Xm       , Gs^Fp       , Hh^Fp       , Gs^Fp       , Ss          , Ss          , Ss          , Ss          , Ss          , Hh^Fp       , Mm^Xm       , Mm^Xm       , Mm^Xm       , Mm^Xm       , Mm^Xm       , Mm^Xm       , Mm^Xm       , Mm^Xm       , Mm^Xm       , Mm^Xm       , Mm^Xm       , Mm^Xm       , Mm^Xm       , Mm^Xm       , Mm^Xm       , Mm^Xm       
Mm^Xm       , Mm^Xm       , Mm^Xm       , Mm^Xm       , Mm^Xm       , Mm          , Gs^Fp       , Gs^Fp       , Re^Gvs      , Gs^Fp       , Gs^Fp       , Gs^Fp       , Rp          , Gs^Fp       , Re          , Ss          , Ss^Bw/      , Ss^Vm       , Ss          , Ss          , Gs^Fp       , Hh^Fp       , Gs^Fp       , Hh^Fp       , Hh^Fp       , Mm^Xm       , Mm^Xm       , Mm^Xm       , Mm^Xm       , Mm^Xm       , Mm^Xm       , Mm^Xm       , Mm^Xm       , Mm^Xm       , Mm^Xm       , Mm^Xm       , Mm^Xm       
Mm^Xm       , Mm^Xm       , Mm^Xm       , Mm^Xm       , Mm          , Gs^Fp       , Gs^Fp       , Gs^Vl       , Re^Gvs      , Re^Gvs      , Rp          , Rp          , Chr         , Rp          , Rp          , Ss^Bw/      , Ss          , Ss          , Ss          , Ss          , Hh          , Hh^Es       , Hh^Fp       , Ss          , Hh^Fp       , Mm^Xm       , Mm^Xm       , Mm^Xm       , Mm^Xm       , Mm^Xm       , Mm^Xm       , Mm^Xm       , Mm^Xm       , Mm^Xm       , Mm^Xm       , Mm^Xm       , Mm^Xm       
Mm^Xm       , Mm^Xm       , Hh^Fp       , Mm^Xm       , Hh^Fp       , Gs^Fp       , Re^Gvs      , Re^Gvs      , Rp          , Rp          , Chr         , Chr         , Hh          , Ch          , Chw         , 2 Khw       , Wwf         , Ss          , Ss          , Ss          , Gg^Efm      , Gs^Fp       , Ss          , Ss          , Hh          , Mm          , Mm^Xm       , Mm^Xm       , Mm          , Mm^Xm       , Mm^Xm       , Mm^Xm       , Mm^Xm       , Mm^Xm       , Mm^Xm       , Mm^Xm       , Mm^Xm       
Hh^Fp       , Hh^Fp       , Gs^Fp       , Mm          , Gg^Es       , Hh^Fp       , Gg          , Gg^Efm      , Rp          , Chr         , Wwg         , Wwg         , Wwg         , Gg^Efm      , Gs^Fp       , Wwf         , Wwf         , Wwf         , Wwf         , Ss          , Gg^Efm      , Gg^Efm      , Gg^Efm      , Gs^Fp       , Gs^Fp       , Hh^Fp       , Mm^Xm       , Mm^Xm       , Hh          , Gs^Fp       , Ss          , Mm^Xm       , Mm^Xm       , Mm^Xm       , Mm^Xm       , Mm^Xm       , Mm^Xm       
Gs^Fp       , Gs^Fp       , Ggf^Efm     , Gg^Es       , Gg          , Gg          , Rp          , Rp          , Wwf         , Wwg         , Wog         , Wog         , Wog         , Wwr         , Wwg         , Wwf         , Wwg         , Wwf         , Wwf         , Gg^Efm      , Gg^Vo       , Gg^Efm      , Gg^Efm      , Gg^Efm      , Hh          , Hh^Fp       , Hh^Fp       , Mm          , Re          , Gs^Fp       , Ss          , Hh          , Mm          , Mm^Xm       , Mm^Xm       , Mm^Xm       , Mm^Xm       
Ss          , Gg          , Gg^Vo       , Gg          , Re          , Rp          , Hh          , Wwf         , Wwf         , Wog         , Wwrg        , Xu          , Uu^Uf       , Wog         , Wog         , Wwf         , Wog         , Wwg         , Wwg         , Gg^Efm      , Gg          , Re          , Gg          , Rd          , Rd          , Ko          , Hh          , Re          , Gs^Fp       , Ss^Vhs      , Ss          , Re          , Hh          , Mm^Xm       , Mm^Xm       , Mm^Xm       , Mm^Xm       
Gs^Fp       , Gg          , Gg          , Gg          , Rp          , Rp          , Rb          , Wwf         , Wwrg        , Wog         , Xu          , Uh^Es       , Xuce        , Cud         , Wwf         , Ur^Es       , Uh          , Wog         , Wog         , Wwg         , Wwg         , Gg          , Gg          , Hh          , Co          , Co          , Co          , Re          , Co          , Gs^Fp       , Hh          , Gs^Fp       , Gs^Fp       , Mm          , Hh          , Mm^Xm       , Mm          
Chr         , Ggf^Efm     , Rp          , Rp          , Hh          , Gg^Efm      , Gg          , Ss^Vhs      , Wwf         , Wwg         , Wog         , Xu          , Xu          , Xu          , Uu^Uf       , Ur          , Xu          , Wwf         , Wwrg        , Wog         , Wwg         , Wwf         , Gg          , Co          , Rp          , Hh          , Re          , Co          , Gg^Efm      , Gg^Efm      , Gg^Efm      , Hh          , Gg          , Hh^Fp       , Gs^Fp       , Mm          , Mm          
Rp          , Rp          , Ggf^Efm     , Re          , Re          , Gs^Fp       , Gg          , Gg          , Gg          , Wwg         , Wwg         , Wog         , Wog         , Wwf         , Xu          , Xu          , Wwg         , Uu^Uf       , Xu          , Wog         , Wwg         , Wwf         , Rp          , Rp          , Gg          , Gg          , Gg          , Hh          , Gg^Efm      , Hh          , Hh          , Gg          , Gg          , Hh^Vo       , Gs^Fp       , Hh^Fp       , Hh          
Gs^Fp       , Chr         , Gg          , Gg          , Re          , Hh^Fp       , Gg          , Gg          , Gg          , Hh^Fp       , Hh          , Wwg         , Wwg         , Wwf         , Rb^Fp       , Wwg         , Uu^Uf       , Uu          , Xu          , Wog         , Wwg^Bw/     , Wwf^Bw/     , Wwf         , Gg          , Gg          , Gg          , Aa^Efm      , Gg^Efm      , Gg^Efm      , Gg          , Gs^Fp       , Hh^Fp       , Gg          , Gg          , Co          , Mm          , Hh          
Hh          , Gs^Fp       , Gg          , Ggf^Efm     , Re          , Hh          , Gg          , Gg^Efm      , Gg^Efm      , Gg          , Gg          , Rb^Fp       , Wwf         , Wwf         , Wwf         , Chw         , Wog         , Wwg         , Wog^Bw/     , Wog^Bw/     , Wwrg        , Wwg         , Wwf         , Ss^Vhs      , Gg^Efm      , Gg^Efm      , Ha^Fpa      , Gg^Efm      , Gg^Efm      , Gg          , Gg          , Hh          , Gg          , Gg          , Gg          , Hh          , Hh          
Hh          , Hh          , Hh^Fp       , Gg          , Gg          , Re          , Hh^Uf       , Gg          , Gg          , Gg          , Gg^Vo       , Wwf         , Gg          , Wwf         , Wwf         , Wwg         , Wwg^Bw/     , Wwg^Bw/     , Ur          , Ur          , Aa^Fpa      , Wog         , Wwf         , Wwrg        , Gg          , Gg^Efm      , Ms          , Aa^Efm      , Gg^Efm      , Gg          , Rd          , Gg          , Gg          , Gg^Efm      , Gg          , Gg          , Rp          
Gg          , Rd          , Gg          , Hh^Vo       , Gg          , Re          , Mm^Xm       , Md          , Gg          , Gg          , Re^Uf       , Hh          , Re^Gvs      , Gg          , Chr         , Wwf^Bw/     , Wwf         , Wwrg        , Ha          , Cud         , Xu          , Uu^Uf       , Wwf         , Wwf         , Wwf         , Gg^Efm      , Re^Uf       , Aa^Fpa      , Gg          , Gg          , Gg          , Gg^Vo       , Re          , Gg          , Rp          , Rp          , Hh          
Gg          , Gg^Efm      , Gg          , Gg          , Gg          , Re          , Gs^Fp       , Hh          , Gg          , Gg          , Re^Gvs      , Re^Gvs      , Re^Gvs      , Re^Gvs      , Rp          , Wwf         , Wwf         , Wwf         , Wwf         , Ur          , Uu          , Xu          , Xu          , Ai          , Wwf         , Wwf         , Gg          , Gg          , Gg^Efm      , Gg          , Re          , Re          , Re^Gvs      , Re          , Rp          , Hh          , Hh^Fp       
Hh          , Gg^Es       , Gs^Fp       , Gg          , Gg          , Co          , Gg          , Gg          , Gg^Efm      , Gg^Efm      , Aa^Fpa      , Re^Gvs      , Gg^Wm       , Re^Gvs      , Rp          , Wwf         , Gg^Fet      , Wog         , Uu^Uf       , Uu          , Wwf         , Kud         , Uu^Uf       , Uu^Uf       , Wog         , Wwf         , Gg          , Gg^Efm      , Hh^Uf       , Hh          , Ha^Fpa      , Re^Gvs      , Re^Gvs      , Re^Gvs      , Rp          , Gll^Fp      , Khr         
Mm          , Hh          , Rp          , Gg          , Gg^Efm      , Re          , Gg          , Gg^Efm      , Ha^Fpa      , Ms^Xm       , Ms          , Hh          , Hh^Uf       , Re^Gvs      , Rp          , Wwf         , Wwf         , Uu^Uf       , Xu          , Kud         , Uu          , Uu          , Wwf         , Wog         , Wwg         , Wwf         , Gg          , Hh^Fp       , Ha          , Ms^Xm       , Hh^Uf       , Dd^Dc       , Re^Gvs      , Re^Gvs      , Rp          , Rr          , Kh          
Mm          , Co          , Rp^Es       , Gg          , Ds          , Re          , Gg          , Gg^Efm      , Gg^Efm      , Ms^Xm       , Ha          , Gs^Fp       , Re^Gvs      , Re^Gvs      , Rp          , Wwf         , Wwg         , Wog         , Uu^Uf       , Xu          , Xu          , Ur          , Wwf         , Wwf         , Wwf         , Wwf         , Gg          , Gg^Efm      , Gg          , Gs^Fp       , Gg^Efm      , Re          , Re          , Re^Gvs      , Rp          , Rr          , Khr         
Mm          , Mm          , Hh          , Hh^Uf       , Re          , Re          , Gg          , Gg          , Gg          , Gg^Efm      , Gg^Efm      , Re^Gvs      , Re^Gvs      , Re^Gvs      , Chr         , Wwf^Bw\     , Wwg^Bw\     , Wwg         , Wwrg        , Aa^Fpa      , Cud         , Ur          , Wwg         , Gg^Fet      , Wwf         , Wwf         , Gg          , Gg          , Gg          , Gg          , Gg^Efm      , Gg          , Gs^Fp       , Re          , Rp          , Hh          , Md          
Hh          , Gs^Fp       , Gg          , Gg          , Re          , Gg          , Gs^Fp       , Mm          , Co          , Gg^Efm      , Gg          , Gg          , Gg          , Gg          , Gg^Efm      , Wwf         , Wwg         , Wog^Bw\     , Wwg^Bw\     , Ur          , Ur          , Ha          , Wog         , Wwf         , Wwf         , Gg          , Gg^Efm      , Ms          , Ha          , Gg          , Gg          , Gg          , Gg          , Gg          , Rp          , Md          , Hh          
Ss          , Hh^Es       , Gg          , Gg^Efm      , Re          , Ss          , Hh^Uf       , Mm^Xm       , Hh          , Gg          , Re          , Re^Uf       , Gs^Fp       , Gg          , Rb          , Wwf         , Chw         , Xu          , Wog         , Wwg^Bw\     , Wwg^Bw\     , Wwrg        , Wwg         , Wwf         , Ss^Vhs      , Gg          , Gg^Efm      , Aa^Fpa      , Aa^Efm      , Gg^Efm      , Gg^Vo       , Gg          , Gg^Efm      , Gg          , Gg          , Rp          , Rp          
Ss          , Gg          , Gg          , Gg          , Re          , Gg          , Gg          , Gll^Fp      , Gg^Efm      , Gg          , Gg          , Gg^Vo       , Wwf         , Gg          , Wwf         , Wwf         , Rb^Fp       , Uu^Uf       , Uh          , Wwrg        , Wog         , Wog^Bw\     , Wwg^Bw\     , Wwf         , Gg          , Gg          , Gg^Efm      , Aa          , Gg^Efm      , Gg^Efm      , Gg          , Gg          , Gg          , Hh          , Gg^Es       , Gg          , Gll^Fp      
Hh          , Gg          , Hh^Fp       , Hh^Vo       , Re          , Gg^Efm      , Gg          , Gg^Efm      , Gg          , Gg          , Gg^Efm      , Gg          , Hh          , Wwf         , Wwg         , Wwg         , Wwrg        , Xu          , Xu          , Wwf         , Xu          , Wwg         , Wwg         , Wwf^Bw\     , Rp          , Gg          , Gg          , Ha^Fpa      , Gg          , Rd          , Gg          , Gg          , Hh          , Co          , Gs^Fp       , Gll^Fp      , Hh          
Gs^Fp       , Hh          , Hh          , Gg          , Re          , Gg          , Gg          , Hh          , Hh^Fp       , Gg          , Gg^Efm      , Gg          , Gs^Fp       , Wwf         , Wwf         , Wwg         , Xu          , Xuce        , Uh^Es       , Uu^Uf       , Xu          , Wog         , Wwg         , Wwf         , Gg^Efm      , Rp          , Gg          , Gg          , Gg          , Gg          , Gg          , Rp^Es       , Gs^Fp       , Mm^Xm       , Mm^Xm       , Mm          , Hh          
Hh^Fp       , Gs^Fp       , Gg          , Gg          , Re          , Gg          , Hh          , Co          , Gg          , Gg          , Gg          , Gg          , Wwg         , Wwg         , Wog         , Wwg         , Uu^Uf       , Cud         , Uu^Uf       , Wog         , Wog         , Wog         , Wwg         , Gg          , Gg^Efm      , Rp          , Hh^Fp       , Hh          , Gg          , Gg          , Rp          , Hh          , Hh          , Mm          , Mm^Xm       , Mm^Xm       , Mm^Xm       
Mm^Xm       , Hh^Fp       , Gg          , Gg          , Re          , Gs^Fp       , Hh          , Rd          , Gg          , Gg          , Ss^Vhs      , Wwf         , Wwg         , Wog         , Uu^Uf       , Wwrg        , Xu          , Ur          , Wwf         , Wog         , Wwg         , Wwg         , Re          , Gg          , Rp          , Rp          , Gg^Vo       , Gg          , Gg          , Gg          , Gg^Efm      , Gs^Fp       , Mm          , Mm^Xm       , Mm^Xm       , Mm^Xm       , Mm^Xm       
Mm^Xm       , Hh          , Hh          , Gs^Fp       , Gs^Vl       , Re          , Re          , Gg          , Gg^Efm      , Gg          , Wwf         , Wwrg        , Wog         , Wog         , Xu          , Xu          , Wog         , Wog         , Wwf         , Wwg         , Gg          , Gg          , Gg          , Gs^Fp       , Rp          , Gg^Efm      , Gg          , Gg          , Gg          , Gg^Efm      , Hh^Fp       , Hh^Fp       , Mm          , Mm^Xm       , Mm^Xm       , Mm^Xm       , Mm^Xm       
Mm^Xm       , Mm          , Hh          , Hh^Fp       , Gs^Fp       , Gg          , Re          , Gg          , Gg          , Gg          , Wwf         , Wwf         , Wwg         , Wog         , Wog         , Wog         , Wog         , Wwg         , Wwf         , Chw         , Chr         , Gg          , Gg          , Rp          , Re^Uf       , Gg^Efm      , Hh          , Gg          , Re          , Gs^Fp       , Gs^Fp       , Hh^Fp       , Mm          , Mm^Xm       , Mm^Xm       , Mm^Xm       , Mm^Xm       
Mm^Xm       , Mm^Xm       , Mm          , Ss          , Hh^Fp       , Hh          , Co          , Hh          , Gg          , Gg          , Gg^Efm      , Wwf         , Wwf         , Wwg         , Wwg         , Wwg         , Wwg         , Wwg         , Wwf         , Wwf         , 1 Khw       , Chr         , Chr         , Rp          , Chr         , Hh          , Hh          , Re          , Re^Gvs      , Re^Gvs      , Gs^Fp       , Gs^Fp       , Mm          , Mm^Xm       , Mm^Xm       , Mm^Xm       , Mm^Xm       
Mm^Xm       , Mm^Xm       , Mm^Xm       , Hh          , Dd          , Gs^Fp       , Gs^Fp       , Co          , Co          , Gg          , Hh          , Gg          , Gg          , Gs^Fp       , Gs^Fp       , Wwf         , Wwf         , Wwf         , Wwf         , Wwf         , Ss          , Ss^Bw|      , Ss          , Chr         , Gg^Efm      , Gg^Efm      , Re          , Re^Gvs      , Gs^Vl       , Gs^Fp       , Hh^Fp       , Hh^Fp       , Mm          , Mm^Xm       , Mm^Xm       , Mm^Xm       , Mm^Xm       
Mm^Xm       , Mm^Xm       , Mm^Xm       , Mm          , Hh          , Ss          , Ss          , Hh^Fp       , Gs^Fp       , Co          , Ko          , Hh          , Gg          , Gg^Efm      , Gg          , Gg          , Gg          , Wwf         , Ss          , Ss          , Ss          , Ss^Bw|      , Ss          , Ss          , Ss          , Gg^Efm      , Re          , Re^Gvs      , Re^Gvs      , Gs^Fp       , Gs^Fp       , Hh^Fp       , Mm          , Mm^Xm       , Mm^Xm       , Mm^Xm       , Mm^Xm       
Mm^Xm       , Mm^Xm       , Mm^Xm       , Mm^Xm       , Mm^Xm       , Mm          , Mm          , Hh          , Ss^Vhs      , Hh^Fp       , Ss          , Co          , Re          , Gg          , Gg          , Gg^Vo       , Gg          , Gg^Efm      , Gg^Efm      , Ss          , Ss          , Ss^Vm       , Ss          , Ss          , Ss          , Gs^Fp       , Gs^Fp       , Gs^Fp       , Hh^Fp       , Re^Gvs      , Hh^Fp       , Hh^Fp       , Mm          , Mm^Xm       , Mm^Xm       , Mm^Xm       , Mm^Xm       
Mm^Xm       , Mm^Xm       , Mm^Xm       , Mm^Xm       , Mm^Xm       , Mm^Xm       , Mm^Xm       , Hh          , Mm          , Hh          , Hh          , Hh          , Hh          , Re          , Re          , Gg          , Gg          , Gg^Efm      , Gs^Fp       , Gs^Fp       , Ss          , Ss          , Ss          , Gs^Fp       , Ss          , Ss          , Ss          , Gs^Fp       , Gs^Fp       , Hh^Fp       , Mm          , Mm          , Mm^Xm       , Mm^Xm       , Mm^Xm       , Mm^Xm       , Mm^Xm       
Mm^Xm       , Mm^Xm       , Mm^Xm       , Mm^Xm       , Mm^Xm       , Mm^Xm       , Mm^Xm       , Mm^Xm       , Mm^Xm       , Mm^Xm       , Mm^Xm       , Mm          , Hh          , Hh          , Hh          , Re          , Hh          , Hh          , Hh          , Gs^Fp       , Gs^Fp       , Ss          , Ss          , Ss          , Ss          , Ss          , Ss          , Ss          , Gs^Fp       , Gs^Fp       , Mm          , Mm^Xm       , Mm          , Mm^Xm       , Mm^Xm       , Mm^Xm       , Mm^Xm       
