border_size=1
usage=map

Xv          , Xv          , Xv          , Xv          , Xv          , Xv          , Xv          , Xv          , Xv          , Xv          , Xv          , Xv          , Xv          , Xv          , Xv          , Xv          , Xv          , Xv          , Xv          , Xv          , Xv          , Xv          , Xv          , Xv          , Xv          , Xv          , Xv          , Xv          , Xv          , Xv          , Xv          , Xv          , Xv          , Xv          , Xv          
Xv          , Xv          , Xv          , Xv          , Xv          , Xv          , Wo          , Wo          , Wo          , Wo          , Wo          , Ai          , Wo          , Wo          , Wo          , Wo          , Wo          , Xv          , Xv          , Xv          , Xv          , Xv          , Xv          , Xv          , Xv          , Xv          , Xv          , Xv          , Xv          , Xv          , Xv          , Xv          , Xv          , Xv          , Xv          
Xv          , Xv          , Xv          , Xv          , Wo          , Wo          , Ww          , Ww          , Ww          , Ww          , Ww          , Wo          , Ww          , Ww          , Ww          , Ww          , Ww          , Wo          , Wo          , Xv          , Xv          , Xv          , Xv          , Xv          , Xv          , Xv          , Xv          , Xv          , Xv          , Xv          , Xv          , Xv          , Xv          , Xv          , Xv          
Xv          , Xv          , Wo          , Wo          , Ww          , Ww          , Wwf         , Wwf         , Wwf         , Wwf         , Wwf         , Ww          , Ai^Vu       , Ai          , Ai          , Wwf         , Wwf         , Ww          , Ww          , Wo          , Wo          , Xv          , Ai          , Rr          , Md          , Xv          , Xv          , Xv          , Xv          , Xv          , Xv          , Xv          , Xv          , Xv          , Xv          
Xv          , Xv          , Wo          , Ww          , Wwf         , Wwf         , Wo          , Cha         , Ai          , Ai^Fetd     , Ai^Fp       , Wwf         , Ai          , Rb          , Rb^Uf       , Ai^Fp       , Rb^Dr       , Wwf         , Wo          , Ww          , Rb^Fp       , Ai^Fp       , Rr          , Rr          , Ai^Fp       , Ai          , Ss          , Xv          , Xv          , Xv          , Xv          , Xv          , Xv          , Xv          , Xv          
Xv          , Xv          , Wo          , Ww          , Wwf         , Rb^Uf       , 1 Kha       , Cha         , Rb^Es       , Rb^Fp       , Rb^Edp      , Ai          , Wwf         , Wwf         , Wwf         , Rb^Em       , Wwf         , Wwf         , Wwf         , Wwf         , Rb^Edp      , Wwf         , Rr          , Ai          , Rb^Dr       , Ai          , Ai          , Ss          , Ai          , Xv          , Xv          , Xv          , Xv          , Xv          , Xv          
Xv          , Xv          , Wo          , Ww          , Wwf         , Rb^Em       , Cha         , Rr          , Wwf         , Rb          , Wwf         , Wwf         , Rb^Es       , Rb^Dr       , Ai^Fp       , Wwf         , Ai          , Ai^Uf       , Rb^Es       , Rb^Dr       , Rr          , Wwf         , Rr          , Ai          , Rb^Es       , Rb^Fp       , Md          , Ai          , Wog         , Ai          , Md          , Xv          , Xv          , Xv          , Xv          
Xv          , Xv          , Wo          , Ww          , Ww          , Ai          , Wwf         , Rr          , Rr          , Rr          , Wo^Bw\      , Rr          , Rb          , Ai          , Wwf         , Wwf         , Rb^Fp       , Ai^Em       , Rb          , Rr          , Kha         , Rr          , Rb^Edp      , Rr          , Rr          , Rr          , Rr          , Rb          , Ai          , Ai^Fp       , Rr          , Rr          , Ai          , Xv          , Xv          
Xv          , Xv          , Ai          , Wo          , Ww          , Wwf         , Wwf         , Cha         , Ai          , Wo          , Wo          , Rr          , Rr          , Ai^Vu       , Wwf         , Rb^Edp      , Rb          , Ss          , Rb          , Rr          , Cha         , Cha         , Ai^Fp       , Rb^Uf       , Ai^Em       , Rb^Es       , Rr          , Rb^Fetd     , Rb          , Rr          , Rb^Es       , Rb^Dr       , Ai          , Xv          , Xv          
Xv          , Xv          , Wo          , Wo          , Ww          , Ww          , Wwf         , Ai          , Rb^Em       , Rb^Fp       , Wo          , Ai^Uf       , Ai          , Rr          , Rr          , Wwf         , Wwf         , Rb^Em       , Rr          , Rr          , Ai          , Wog         , Ai          , Ai          , Wwf         , Rb^Vu       , Ai          , Rr          , Rr          , Rr          , Rb^Fp       , Ai          , Ss          , Xv          , Xv          
Xv          , Xv          , Wo          , Ww          , Wwf         , Wwf         , Wwf         , Ai          , Wwf         , Rb^Uf       , Wwf         , Rb^Em       , Ai          , Mm^Xm       , Mm          , Rr          , Kha         , Rb^Uf       , Rr          , Rb^Vo       , Rb          , Ai          , Wwf         , Wwf         , Ss          , Ai          , Rb^Dr       , Rb^Edp      , Wwg^Ewl     , Rr          , Rr          , Ai          , Ai          , Xv          , Xv          
Xv          , Xv          , Wo          , Ww          , Rb^Dr       , Rb^Es       , Rb          , Rb^Vht      , Wwf         , Ww^Ewl      , Rb          , Rb^Es       , Rb          , Ai^Fp       , Rr          , Rr          , Cha         , Wog         , Kha         , Rr          , Rb          , Rr          , Wwf         , Ai          , Ai          , Ss          , Wwf         , Wwf         , Kha         , Wwf         , Ai          , Rr          , Mm^Xm       , Xv          , Xv          
Xv          , Xv          , Wo          , Wwf         , Ms^Xm       , Ai^Em       , Ai^Uf       , Ww^Ewl      , Wwf         , Wo          , Ww^Ewl      , Ai^Fetd     , Ai          , Rb          , Rr          , Rb^Em       , Rb^Uf       , Cha         , Ai^Em       , Rr          , Rr          , Rb          , Rb^Edp      , Rb^Fp       , Rb^Uf       , Ai^Fp       , Wwf         , Ai          , Cha         , Cha         , Rr          , Rr          , Mm          , Xv          , Xv          
Xv          , Xv          , Wwf         , Wwf         , Wwf         , Wwf         , Wwf         , Wo          , Wwf         , Wwf         , Wwf         , Wo          , Kha         , Wwf         , Rr          , Rb          , Ss^Vht      , Ss          , Ww^Ewl      , Ai^Uf       , Rb^Em       , Rr          , Rb          , Rb^Vht      , Rb^Em       , Rb          , Rb^Edp      , Wwf         , Mm          , Rr          , Rb^Dr       , Rb^Fp       , Ss          , Xv          , Xv          
Xv          , Xv          , Wwf         , Wo          , Wwf         , Ww^Ewl      , Wwf         , Ai          , Wwf         , Ww^Ewl      , Rr^Vo       , Ai          , Cha         , Cha         , Rr          , Wwf         , Wo          , Wo          , Wo          , Ai^Fp       , Ai          , Rr          , Rr          , Rb          , Rr          , Rr          , Rr          , Rb^Fp       , Rb^Fp       , Rr          , Rr          , Rr          , Rr          , Xv          , Xv          
Xv          , Xv          , Rb          , Wwf         , Ai          , Wwf         , Wo          , Wwf         , Wo          , Ai^Uf       , Ai^Fp       , Rr          , Rr          , Rr          , Rb^Es       , Rb          , Wwf^Es      , Wwr         , Wwf         , Wwf         , Ai^Fp       , Rb^Dr       , Wo          , Rr          , Wwf         , Wwf         , Wwf         , Rr          , Rr          , Rr          , Cha         , Kha         , Rr          , Xv          , Xv          
Xv          , Xv          , Rb^Es       , Ww^Ewl      , Ai          , Ww^Ewl      , Wwf         , Wwf         , Wo          , Wwf         , Ww^Ewl      , Rb^Edp      , Ai^Fp       , Ai^Dr       , Wo          , Wwf         , Ss^Uf       , Sm^Fp       , Hhd^Em      , Wo          , Wwf         , Wwf         , Ww^Ewl      , Ww^Ewl      , Wwf         , Ww^Ewl      , Wwf         , Ai          , Ai          , Rb          , Rb          , Cha         , Rr          , Xv          , Xv          
Xv          , Xv          , Rr          , Rb          , Rb          , Wwf         , Ai          , Wo          , Wwf         , Wwf         , Wwf         , Wwf         , Ww^Ewl      , Wwf         , Wwf         , Wo          , Hhd^Em      , Ss          , Ss^Uf       , Wo          , Wo          , Wwf         , Ai^Fp       , Wwf         , Ww^Ewl      , Wwf         , Wo          , Wo          , Wwf         , Wwf         , Ai          , Rb          , Rb^Es       , Xv          , Xv          
Xv          , Xv          , Rr          , Cha         , Cha         , Rb          , Rr          , Ai          , Wwf         , Ww^Ewl      , Wwf         , Ww^Ewl      , Wo          , Wwf         , Ai^Fp       , Wo          , Wwf         , Sm^Fp       , Wwf^Es      , Wwf         , Rb^Es       , Ai^Dr       , Rr          , Rb^Edp      , Ai^Fp       , Wwf         , Wo          , Wwf         , Wo          , Ww^Ewl      , Ai          , Ww^Ewl      , Rb          , Xv          , Xv          
Xv          , Xv          , Rr          , Kha         , Rr          , Rr          , Rb^Fp       , Rr          , Rr          , Wwf         , Rr          , Rr          , Rr          , Rb^Dr       , Ai          , Wwf         , Wo          , Wwr         , Wo          , Rb          , Rr          , Rr          , Cha         , Rr          , Rr^Vo       , Ai^Uf       , Wwf         , Wwf         , Wwf         , Wwf         , Wwf         , Wwf         , Wwf         , Xv          , Xv          
Xv          , Xv          , Ss          , Rr          , Rb^Dr       , Rr          , Mm          , Rb^Fp       , Rb^Edp      , Rr          , Rb^Em       , Rb          , Rb          , Rr          , Rb^Em       , Ai^Fp       , Ww^Ewl      , Wo          , Ss^Vht      , Wwf         , Rr          , Cha         , Kha         , Ai          , Wwf         , Ww^Ewl      , Wwf         , Ai          , Wwf         , Ww^Ewl      , Wwf         , Wo          , Wwf         , Xv          , Xv          
Xv          , Xv          , Mm          , Rb^Fp       , Rr          , Rr          , Cha         , Wwf         , Wwf         , Rb          , Rb^Uf       , Rb^Vht      , Rb^Edp      , Rr          , Rr          , Ai^Uf       , Ai^Em       , Ss          , Rb^Uf       , Rb          , Rr          , Wwf         , Ai          , Wo          , Ww^Ewl      , Wwf         , Wwf         , Wo          , Ai^Uf       , Wwf         , Ms^Xm       , Wwf         , Wo          , Xv          , Xv          
Xv          , Xv          , Mm^Xm       , Rr          , Ai          , Cha         , Kha         , Ai          , Wwf         , Ai^Fp       , Ai          , Rb^Fp       , Wwf         , Rb          , Rb          , Rr          , Kha         , Cha         , Cha         , Rb^Em       , Rr          , Rb          , Rb          , Ai^Fetd     , Rb          , Wo          , Wwf         , Ww^Ewl      , Rb          , Ai^Em       , Rb^Dr       , Wwf         , Wo          , Xv          , Xv          
Xv          , Xv          , Ai          , Rr          , Rr          , Wwf         , Wwg^Ewl     , Wwf         , Rb^Dr       , Ss          , Ss          , Ai          , Wwf         , Rr          , Rb          , Rr          , Rr          , Wog         , Kha         , Rr          , Mm          , Ai^Fp       , Ai          , Rb^Es       , Wwf         , Ww^Ewl      , Wwf         , Rb^Vht      , Wwf         , Rb^Es       , Wwf         , Ww          , Wo          , Xv          , Xv          
Xv          , Xv          , Ss          , Ai          , Rb^Fp       , Rr          , Rr          , Rb^Edp      , Ai          , Ai          , Wwf         , Wwf         , Ai          , Ai          , Ai          , Rb^Vo       , Rr          , Rb^Uf       , Wwf         , Rr          , Rr          , Mm^Xm       , Ai          , Rb^Em       , Wo          , Rb^Uf       , Rb^Em       , Ai          , Wwf         , Wwf         , Ww          , Ww          , Wo          , Xv          , Xv          
Xv          , Xv          , Ai          , Ai          , Rb^Es       , Rr          , Rb          , Rr          , Rr          , Rb^Vu       , Ai^Em       , Ai          , Ai^Fp       , Wog         , Cha         , Rr          , Rb          , Rb^Em       , Rb          , Wwf         , Wwf         , Rr          , Rr          , Ai^Uf       , Wo          , Rb^Fp       , Ai          , Ai          , Wwf         , Ww          , Ww          , Wo          , Ai          , Xv          , Xv          
Xv          , Xv          , Ai          , Rb^Dr       , Rr          , Rr          , Ai          , Rb^Fetd     , Rr          , Rb^Es       , Rr          , Rb^Uf       , Rb^Edp      , Cha         , Kha         , Rr          , Rb          , Ss          , Rb^Fp       , Rb^Edp      , Wwf         , Ai^Vu       , Rb          , Rr          , Wo^Bw\      , Wo          , Rr          , Cha         , Wwf         , Wwf         , Ww          , Wo          , Wo          , Xv          , Xv          
Xv          , Xv          , Xv          , Rr          , Md          , Ai^Fp       , Wog         , Rb          , Md          , Rr          , Rb^Es       , Rr          , Rr          , Rr          , Rr          , Rr          , Rb^Es       , Ai^Em       , Ai          , Wwf         , Ai^Fp       , Ai          , Rb^Es       , Rr          , Wwf         , Rr          , Wwf         , Rr          , Cha         , Ai          , Wwf         , Ww          , Wo          , Xv          , Xv          
Xv          , Xv          , Xv          , Xv          , Xv          , Ai          , Ai          , Ai          , Ai          , Rb^Fp       , Rb^Dr       , Ai          , Rr          , Wwf         , Rb^Edp      , Rb^Dr       , Wwf         , Ai^Uf       , Wwf         , Wwf         , Wwf         , Rb^Dr       , Wwf         , Wwf         , Rb^Edp      , Rb          , Rb^Es       , Rr          , 2 Kha       , Rb^Em       , Wwf         , Ww          , Wo          , Xv          , Xv          
Xv          , Xv          , Xv          , Xv          , Xv          , Xv          , Xv          , Ss          , Ss          , Ai          , Ai^Fp       , Ai          , Rr          , Wwf         , Rb^Fp       , Wwf         , Wo          , Wwf         , Rb^Dr       , Rb^Em       , Rb^Uf       , Wwf         , Ai          , Ai          , Ai^Fp       , Rb^Fp       , Ai          , Cha         , Wo          , Rb^Uf       , Wwf         , Ww          , Wo          , Xv          , Xv          
Xv          , Xv          , Xv          , Xv          , Xv          , Xv          , Xv          , Xv          , Xv          , Ai          , Md          , Rr          , Ai          , Ai^Fp       , Wo          , Ww          , Ww          , Wwf         , Wwf         , Ai^Fp       , Ai          , Rb          , Ai^Vu       , Wwf         , Wwf         , Ai^Fetd     , Wwf         , Cha         , Wwf         , Wwf         , Ww          , Ww          , Wo          , Xv          , Xv          
Xv          , Xv          , Xv          , Xv          , Xv          , Xv          , Xv          , Xv          , Xv          , Xv          , Xv          , Rr          , Xv          , Xv          , Xv          , Wo          , Wo          , Ww          , Ww          , Wwf         , Ww          , Ai          , Ww          , Ww          , Ww          , Wwf         , Ww          , Wwf         , Ww          , Ww          , Wo          , Wo          , Xv          , Xv          , Xv          
Xv          , Xv          , Xv          , Xv          , Xv          , Xv          , Xv          , Xv          , Xv          , Xv          , Xv          , Xv          , Xv          , Xv          , Xv          , Xv          , Xv          , Wo          , Wo          , Ww          , Wo          , Ww          , Wo          , Wo          , Wo          , Ww          , Wo          , Ww          , Wo          , Wo          , Xv          , Xv          , Xv          , Xv          , Xv          
Xv          , Xv          , Xv          , Xv          , Xv          , Xv          , Xv          , Xv          , Xv          , Xv          , Xv          , Xv          , Xv          , Xv          , Xv          , Xv          , Xv          , Xv          , Xv          , Wo          , Xv          , Wo          , Xv          , Ai          , Xv          , Wo          , Xv          , Wo          , Xv          , Xv          , Xv          , Xv          , Xv          , Xv          , Xv          
Xv          , Xv          , Xv          , Xv          , Xv          , Xv          , Xv          , Xv          , Xv          , Xv          , Xv          , Xv          , Xv          , Xv          , Xv          , Xv          , Xv          , Xv          , Xv          , Xv          , Xv          , Xv          , Xv          , Xv          , Xv          , Xv          , Xv          , Xv          , Xv          , Xv          , Xv          , Xv          , Xv          , Xv          , Xv          
