border_size=1
usage=map

Ss^Fdw      , Ss^Fdw      , Wwg         , Wwg         , Ss          , Ss          , Ss          , Wwg         , Ss^Xo       , Ss^Fdw      , Ss^Xo       , Wwg         , Wwg         , Wwg         , Ss^Xo       , Ss^Fdw      , Rb^Xo       , Rp^Xo       , Rp^Xo       , Rb          , Ss          , Ss^Fdw      , Wwg         , Ss^Xo       , Ss^Xo       , Ss^Xo       , Wog^Xo      , Ss^Xo       , Wwg^Xo      , Wwg^Xo      , Wwg^Xo      , Ss^Xo       , Wwg^Xo      
Ss          , Ss^Xo       , Wwg         , Ss^Xo       , Ss^Fdw      , Ss^Xo       , Ss^Fdw      , Wwg^Xo      , Wwg         , Ss^Xo       , Ss^Uf       , Ss^Xo       , Wwf         , Ss^Xo       , Ss^Uf       , Rb^Xo       , Rp^Efm      , Rp^Xo       , Rb          , Rb^Xo       , Ss^Fdw      , Ss^Xo       , Ss          , Wwg^Xo      , Wwg         , Wwg^Xo      , Ss          , Wwg^Xo      , Ss^Fdw      , Ss^Xo       , Wog         , Wwg^Xo      , Ss          
Wwg         , Wwg         , Ss^Uf       , Wwg         , Wwf         , Ss^Uf       , Rb^Fdw      , Mm          , Hh^Fdw      , Wog         , Wwf         , Hh          , Rb^Fdw      , Wwf         , Rb          , Rb          , Rp^Efm      , Rp^Efm      , Rb          , Ss          , Rb          , Ss          , Mm          , Ss^Fdw      , Wog         , Ss          , Ss^Vhr      , Ss^Fdw      , Rb^Fdw      , Hh          , Rb^Fdw      , Ss^Fdw      , Wwg         
Ss          , Ss^Fdw      , Rb          , Rb          , Wwf         , Hh^Fdw      , Rb          , Rb          , Wwf         , Wwf         , Rb          , Rb^Vhs      , Rb          , Wwf         , Khs         , Rp^Efm      , Chr         , Rp^Efm      , 1 Khs       , Rb          , Rb          , Ss^Uf       , Hh^Fdw      , Hh^Uf       , Rb          , Ss^Uf       , Rb          , Rb          , Rb          , Rb          , Rb          , Ss^Uf       , Hh^Fdw      
Ss^Fdw      , Ss          , Rb          , Wwf         , Rb          , Wwf         , Wwf         , Wwf         , Rb          , Rb          , Rb          , Rb          , Rb          , Wwf         , Chw         , Chr         , Khs         , Chr         , Chw         , Rb          , Rb^Efm      , Re          , Re          , Rb          , Rb          , Rb          , Rb          , Rb          , Ss^Uf       , Rb          , Re          , Rb          , Rb          
Ss^Fdw      , Rb          , Wwf         , Wwf         , Hh          , Rb          , Wwf         , Ss^Uf       , Rb          , Rb          , Rb^Fdw      , Mm          , Hh          , Rb          , Rb          , Wwf         , Wwf         , Wwf         , Rb          , Wwf         , Wwf         , Rb          , Re          , Re^Vhcr     , Re^Efm      , Re          , Rb          , Ss          , Hh          , Mm          , Re^Efm      , Re          , Rb          
Wwg         , Wwg         , Rb          , Hh^Fdw      , Rb^Fdw      , Wwf         , Rb          , Ss^Vhr      , Rb          , Rb          , Rb          , Ss^Uf       , Rb          , Rb          , Rb          , Wwf         , Mm^Xm       , Rb          , Ss          , Rb          , Rb          , Wwf         , Hh          , Rb          , Re          , Re          , Re          , Rb          , Rb          , Re^Uf       , Re          , Rb          , Ss^Fdw      
Wwg         , Ss^Uf       , Rb          , Mm^Xm       , Wwf         , Wwf         , Rb^Fdw      , Rb          , Rb          , Re          , Re^Efm      , Rb          , Re          , Rb          , Wwf         , Wwf         , Hh          , Mm^Xm       , Mm^Xm       , Ss^Uf       , Hh^Fdw      , Wwf         , Rb          , Mm          , Ss^Uf       , Re          , Re^Vhhr     , Re^Fdw      , Rb          , Re          , Rb          , Rb          , Ss          
Ss^Fdw      , Wwg         , Wog         , Wwf         , Wog         , Hh          , Mm          , Rb          , Re          , Re          , Re          , Re          , Rb          , Rb          , Wwf         , Rb          , Rb^Fdw      , Mm          , Mm^Xm       , Mm          , Rb^Fdw      , Ss^Vhs      , Wwf         , Rb^Fdw      , Rb          , Rb          , Re          , Re          , Rb          , Rb          , Rb          , Wog         , Wwg         
Mm^Xm       , Mm^Xm       , Hh^Fdw      , Wwf         , Rb          , Mm^Xm       , Ss^Uf       , Hh^Fdw      , Rb          , Rb          , Rb^Vhhr     , Rb          , Hh          , Hh^Fdw      , Wwf         , Ss^Vhs      , Wog         , Ss^Fdw      , Mm^Xm       , Hh          , Wwf         , Wwf         , Rb          , Wwf         , Rb          , Rb          , Rb          , Rb          , Ss          , Ss^Uf       , Ss^Bw|r     , Ss^Fdw      , Ss          
Wwg         , Mm^Xm       , Wwf         , Wwf         , Rb          , Ss          , Rb          , Rb          , Rb          , Wwf^Uf      , Wwf         , Wwf         , Wwf         , Mm^Xm       , Wwg         , Wog         , Wwg         , Ss^Uf       , Ss          , Mm^Xm       , Wwf         , Rb          , Rb          , Wwf         , Wwf         , Rb^Efm      , Rb          , Rb^Fdw      , Hh^Fdw      , Mm          , Rb          , Ss          , Ss          
Wwg         , Wwg         , Rb          , Wwf         , Wwf         , Rb^Efm      , Rb          , Rb          , Rb          , Wwf         , Rb          , Rb          , Wwf         , Mm^Xm       , Ss^Uf       , Wwf         , Wwf         , Wwg         , Wwg         , Mm^Xm       , Wog         , Hh^Fdw      , Ss^Uf       , Rb^Fdw      , Wwf         , Rb          , Rb          , Rb          , Rb          , Hh          , Rb          , Rb          , Ss^Fdw      
Ss          , Rb          , Ss^Uf       , Rb          , Wwf         , Rb          , Rb^Fdw      , Rb          , Rb          , Rb          , Rb          , Rb          , Rb          , Wwg         , Wog         , Mm^Xm       , Ss^Uf       , Wwf         , Wwg         , Wog         , Rb^Fdw      , Mm          , Rb          , Rb          , Chs         , Chw         , Wwf         , Rb          , Rb          , Rb          , Ss          , Rb          , Ss^Fdw      
Ss^Fdw      , Ss^Bw|r     , Ss          , Rb^Fdw      , Rb          , Wwf         , Wwf         , Chs         , Chs         , Rb          , Rb          , Rb          , Rb^Fdw      , Ss^Uf       , Wwg         , Wog         , Ss^Uf       , Wog         , Wog         , Ss^Uf       , Rb          , Rb          , Rb          , Rb          , Rb          , Chs         , Rb^Fdw      , Wwf         , Wwf         , Rb^Fdw      , Ss^Uf       , Ss^Bw|r     , Ss          
Ss^Fdw      , Rb          , Rb          , Rb          , Rb          , Rb          , Rb          , Chw         , Wwf         , Rb          , Ss^Uf       , Mm          , Wog         , Wog         , Wwg         , Wwf         , Wwf         , Mm^Xm       , Ss^Uf       , Wwg         , Wwf         , Rb          , Rb          , Rb          , Rb          , Rb          , Rb          , Rb          , Wwf         , Rb          , Rb          , Rb          , Wwg         
Ss          , Rb          , Rb          , Hh          , Hh^Fdw      , Rb          , Rb          , Rb          , Wwf         , Rb^Fdw      , Rb          , Hh^Fdw      , Wwf         , Mm^Xm       , Ss          , Wwg         , Wwg         , Wwf         , Wwg         , Mm^Xm       , Wwf         , Rb          , Wwf         , Wwf         , Rb          , Rb          , Rb          , Rb^Efm      , Rb          , Wwf         , Wwf         , Wwg         , Wwg         
Ss          , Ss          , Ss^Bw|r     , Mm          , Ss          , Rb^Fdw      , Rb          , Rb^Efm      , Rb          , Wwf         , Rb          , Rb          , Wwf         , Mm^Xm       , Mm^Xm       , Ss^Uf       , Wog         , Wog         , Wwf         , Mm^Xm       , Hh          , Wwf         , Rb^Vhhr     , Wwf^Uf      , Rb          , Rb          , Ss^Uf       , Ss          , Rb          , Wwf         , Hh          , Mm^Xm       , Mm^Xm       
Wwg         , Ss^Fdw      , Rb          , Ss^Uf       , Rb          , Rb          , Re          , Rb          , Rb          , Wwf         , Wwf         , Wwf         , Rb^Fdw      , Hh          , Mm^Xm       , Ss^Fdw      , Rb^Fdw      , Ss^Vhs      , Wwf         , Hh^Fdw      , Rb          , Rb          , Re          , Rb          , Re          , Hh^Fdw      , Mm          , Mm^Xm       , Wog         , Wwf         , Wog         , Mm^Xm       , Ss^Fdw      
Ss          , Wog         , Rb          , Rb          , Rb          , Re          , Re^Vhhr     , Rb          , Ss^Uf       , Rb^Fdw      , Rb          , Ss^Vhs      , Hh^Fdw      , Mm          , Mm^Xm       , Mm          , Hh          , Rb          , Wwf         , Rb          , Re          , Re          , Re^Efm      , Re          , Rb          , Rb          , Rb^Fdw      , Hh          , Wwf         , Wwf         , Rb          , Wwg         , Wwg         
Ss^Fdw      , Rb          , Re          , Re          , Rb          , Re^Fdw      , Re          , Re          , Re          , Mm          , Hh          , Wwf         , Rb          , Ss^Uf       , Ss          , Mm^Xm       , Mm^Xm       , Wwf         , Rb          , Rb          , Rb          , Rb          , Rb          , Re          , Rb          , Rb          , Rb          , Wwf         , Rb^Fdw      , Mm^Xm       , Rb          , Ss^Uf       , Wwg         
Rb          , Rb          , Re^Efm      , Re^Uf       , Hh          , Rb          , Rb          , Re          , Re^Efm      , Rb          , Re          , Wwf         , Wwf         , Rb          , Rb          , Rb          , Wwf         , Wwf         , Rb          , Rb          , Hh          , Ss^Uf       , Rb^Fdw      , Rb          , Rb          , Ss^Vhr      , Wwf         , Wwf         , Hh          , Hh^Fdw      , Wwf         , Wwg         , Ss^Fdw      
Rb          , Re          , Re          , Mm          , Ss^Uf       , Ss          , Rb          , Re          , Rb          , Re^Vhcr     , Re          , Rb          , Rb^Efm      , Wwf         , Chw         , Wwf         , 2 Khs       , Wwf         , Chw         , Rb          , Rb          , Mm          , Rb          , Rb          , Rb          , Ss^Uf       , Wwf         , Rb          , Rb          , Wwf         , Rb          , Rb          , Ss^Fdw      
Hh^Fdw      , Rb          , Rb          , Rb          , Rb          , Rb          , Rb          , Rb          , Rb          , Rb          , Hh^Fdw      , Re          , Rb          , Rb          , Khs         , Chr         , Chr         , Chr         , Khs         , Wwf         , Rb          , Rb          , Rb          , Rb          , Wwf         , Wwf         , Rb          , Wwf         , Wwf         , Wwf         , Rb          , Ss          , Ss          
Wwg         , Ss^Uf       , Rb^Fdw      , Rb          , Rb^Fdw      , Rb          , Ss^Vhr      , Ss^Uf       , Wog         , Ss^Uf       , Mm          , Hh^Uf       , Rb          , Rb          , Rb          , Rp^Efm      , Rp^Efm      , Rp^Efm      , Rb          , Wwf         , Rb^Fdw      , Rb^Vhs      , Wwf         , Wwf         , Hh^Fdw      , Rb          , Rb^Fdw      , Hh^Fdw      , Wwf         , Rb          , Ss^Uf       , Ss^Fdw      , Wwg         
Ss          , Ss^Fdw      , Wog         , Hh          , Ss^Fdw      , Ss^Fdw      , Ss          , Ss          , Wwg         , Ss^Fdw      , Ss          , Ss          , Ss^Fdw      , Ss          , Rb          , Rp^Efm      , Rp^Efm      , Rb          , Ss^Uf       , Wwf         , Wwf         , Hh          , Ss^Uf       , Wog         , Wwg         , Mm          , Ss^Fdw      , Ss^Uf       , Ss^Fdw      , Wwg         , Wwg         , Wwg         , Ss          
Wwg^Xo      , Wwg^Xo      , Wwg^Xo      , Ss^Xo       , Wwg^Xo      , Wwg^Xo      , Wog^Xo      , Wwg^Xo      , Ss^Xo       , Wwg^Xo      , Wwg^Xo      , Ss^Xo       , Ss^Xo       , Rb^Xo       , Rp^Xo       , Rp^Xo       , Rb^Xo       , Rb^Xo       , Ss^Xo       , Ss^Xo       , Wwg^Xo      , Ss^Xo       , Ss^Xo       , Ss^Xo       , Ss^Xo       , Wwg^Xo      , Ss^Xo       , Ss^Xo       , Ss^Xo       , Ss^Xo       , Wwg^Xo      , Ss^Xo       , Ss^Fdw      
Ss^Xo       , Ss^Xo       , Ss^Xo       , Wwg^Xo      , Ss^Xo       , Ss^Xo       , Ss^Xo       , Ss^Xo       , Ss^Fdw      , Ss^Xo       , Wwg^Xo      , Ss^Fdw      , Rb          , Rb          , Rp^Xo       , Rp^Xo       , Rb          , Ss^Fdw      , Ss^Xo       , Ss^Xo       , Ss^Fdw      , Wwg         , Wwg         , Ss^Fdw      , Ss^Fdw      , Wwg^Xo      , Ss^Fdw      , Ss^Fdw      , Wwg         , Wwg         , Ss^Xo       , Ss^Fdw      , Ss^Fdw      
